#########################################
#     #       #       #         #   #   #
# # # # # ### # ### # # ####### # # # # #
#   # # # #   #     # #       #     # # #
# ### # # # # # ##### ##### # ####### # #
# #   # #   # # #   #     #   #       #  
# # # # ##### # # # # ### ##### # ##### #
#   # #       # # #   #   #   # # #     #
# ### ### ##### # ##### ### # # # # # ###
# #       #   # # #     #   # # # # #   #
# # # ##### # # # # ##### ### # # # ### #
# # #     #     # # #       #   # #     #
# # ##### ####### # # ### # ##### # #####
# #   #       #   # #     #       # #   #
# ### # ##### # ### ### ##### ##### # # #
#   # # #     #     #   #   #     #   # #
# # # # # ### ####### ### # ##### ##### #
# # #   #     #         #   #           #
# # ########### # ##### ##### ### ##### #
# #       #   #   #   #         #     # #
# ####### # # ##### # # ####### ##### # #
#         #   #   #   #   #         #   #
##### ### ##### # ####### # ####### #####
#   #   # #     #   #       #     # #   #
# # ### # # ### # # # ####### # # # # # #
#   #   # # #   # #       #   #   # #   #
##### # # # # ### ### ### # ####### #####
#   #   # # #   #   # #   #   #   # #   #
# # ##### # ### # # # # # ### # # # # # #
# # #     # #   # # #   # #   # #   # # #
# # # ### # # # # # ##### # ### ##### # #
# # # #   # # #     #   # #   # #     # #
# # # # ### # ####### # # ### # # ##### #
# #   # #   #     #   # #   # # #     # #
# ##### # ####### # # # ### # # ##### # #
#   #   #   #   # # # #   #   #     #   #
### # # # # # # # # # ### ####### # #####
#   # #   #     # # #   # #     # #     #
# ### ########### # ### # # # # # # ### #
                  #       #   #   #     #
#########################################
