#####################
#     #     #   #   #
# # # # ### # # # # #
# #   # #   #   # # #
# ##### # ####### # #
#     # #       #   #
##### # ####### ### #
#   #   #     #   # #
# # ##### ### # # # #
# #       #   # #   #
# ##### ### ### ### #
#     #   # #       #
### # ### # # # #####
    # #   # # #     #
# ### # ### # ### # #
#     #     #   # # #
### ######### # # # #
#   #   #   # #   # #
# ### # # # # ##### #
#     #   #          
#####################
